7777777777777777777777777777777777777777777777777777777777777777777777777777
7666666660000000000000000000000000000000000000000000000000000000000000000000
7666666660116661666666666666101111111111111110071111171171171171171171171171
7000000000010001000000000000106666666666666600070666000000000000000007007010
7660666066001001000000000000106666666666666600160666077770077700777707007010
7000000000000101000000000000106666666666666006767666010070000000700107717071
7160006666610011111111111111106666666000000006767666070070000000700700007010
7160006611111000000000000000000000000077700660761100077770777770777700000010
7160006610001006771111160077007770777007700777767177000001708071000004444070
7161116610000106700000160770007000007000700000000000000000700070000004444010
7160006610000106707000160700700000000000700000000000077771711171777704444010
7160106610000106707000160007007770777000000077707777070070000000700704444070
7160006610000106707000160070007000007000000070000070070010660660100700000010
7164446611111106707000160070000001000007707770000077077770660660777700000010
7164446610000106707000160070007000007007707007000070000000000000000000000071
7164446610000106707000160007007770777000007000007777000666666666666000000700
7164446610000106707000160700700000000076600000000000000666666666666700070100
7164446610000106700000160770007000007070006666666660060000000000000007000707
7164446610000106771111160077007770777070000000000000060000000000000007000107
7164446610000100666666600000000000000070006666666660000666666666666007000707
7164446611111100666666600700707000007076600000000000000666666666666700070100
0000000000000000000000000770707777777000000000000000000000000000000000000700
7600000000000000000000000000000000000000000000000000000700000000000777000071
7677717000771777707170607170666606666660666666666666607711100000077777000010
7600707000100000101010601010660000066660600000000000601000100000010001000010
7607707000771777707170607170600717006660600000000000601020100660010001066670
7600707000000000000000600000607717706660600000000000601000100660010001066610
7607717770666071707170607170600717006660666666666666607777100660077777066610
7607717770666071707070607070660000066660007777007777000000007007000000007070
7600700000000000000000600000666666666660007970000001000000007007000000007010
7666660660717071707170607170000000000000007010001777006666000000006607717010
0000000660707010107070607070666666666660007070001007006666077177706607007071
7007770000707071707070607070666666666660007070000001006666070000706607007010
7000077007007000000000000000666666666660007777007777006666077777706607777010
7000007000000000000707007070700000000000000000000000000000000000000000000070
7777766677777777777777777770777777777777777777777777777777777777777777777777
