0000000000000000000000000000000000000000000000000000000000000000000000000000000000000070
0000000000000010001666666666666101111111111111110071171171171171171171171171171171171110
0000000000000010001000000000000106666666666666600070666660000000000000000000000777770010
6660666606666001001000000000000106666666666666600160666660077770007777000777700700070070
0000000000000000101000000000000106666666666666006767666660070010000000000100700771170010
0000000006666610011111111111111106666666000000006767666660070010000000000100700000070010
0000000001111111000000000000000000000000077700660761100000077770077777700777700000000070
0000000001000001006771111160077007770777007700777767177770000000770000770000000444400010
0000000001000000106700000160770007000007000700000000000000000000070000700000000444400010
0000000001000000106707000160700700000000000700000000000000077770771111770777700444400070
0000000001000000106707000160007007770777000000077707777770070010000000000100700444400010
1164444661000000106707000160070007000007000000070000007000070010000000000100700000000011
0164444661111111106707000160070000001000007707770000007700077770000000000777700000000700
0164444661000000106707000160070007000007007707007000007000000000000000000000000000000700
0164444661000000106707000160007007770777000007000007777700006666666666666666000000007000
0164444661000000106707000160700700000000076600000000000000006666666666666666070007007000
0164444661000000106700000160770007000007070006666666666006600000000000000000000700007070
0164444661000000106771111160077007770777070006666666666006600000000000000000000700010070
0164444661000000100666666600000000000000070006666666666000006666666666666666000700007070
1164444661111111100666666600700707000007076600000000000000006666666666666666070007007000
0000000000000000000000000000770707777777000000000000000000000000000000000000000000007000
0000000000000000000000000000000000000000000000000000000000070000000000000007777000000700
6777170007717777707170607170666606666666066666666666666000077111100000000777777700000700
6007070001000000101010601010660000066666060000000000006000010000100000000100000100000011
6077070007717177707170607170600717006666060000000000006000010000100666000100000106666010
6007070000000000000000600000607717706666060000000000006000010000100666000100000106666070
6077177706660071707170607170660717066666066666666666666000077777100666000777777706666010
6007000006660010107070607070000000000000000000000000000000070000000000000777777700000010
6077177706660071707070607070666666666666000777700777700000000000070000700000000000070070
6007000000000000000000600000666666666666000797000000100000000000070000700000000000070010
6666606607170071707170607170000000000000000701000177700000000000000000000000000777170010
0000006607070010107070607070666666666666000707000100700000000000777117770000000700070070
0007700007070071707070607070666666666666000707000000100000000000700000070000000700070010
0000770070070000000000000000666666666666000777700777700000000000777777770000000777770010
0000070000000000000717117170000000000000000000000000000000000000000000000000000000000070

